{
    "map": ["4 5 5 5 5 5 5 5 5 5 5 5 5 5 7",
            "6 3 3 0 0 0 0 0 0 0 0 0 3 3 f",
            "6 3 1 0 1 0 1 0 1 0 1 0 1 3 f",
            "6 0 0 0 0 0 0 0 0 0 0 0 0 0 f",
            "6 0 1 0 1 0 1 0 1 0 1 0 1 0 f",
            "6 0 0 0 0 0 0 0 0 0 0 0 0 0 f",
            "a 9 9 9 9 9 b 0 c 9 9 9 9 9 8",
            "4 5 5 5 5 5 d 0 e 5 5 5 5 5 7",
            "6 0 1 0 1 0 1 0 1 0 1 0 1 0 f",
            "6 0 0 0 0 0 0 0 0 0 0 0 0 0 f",
            "6 3 1 0 1 0 1 0 1 0 1 0 1 3 f",
            "6 3 3 0 0 0 0 0 0 0 0 0 3 3 f",
            "a 9 9 9 9 9 9 9 9 9 9 9 9 9 8"],

    "type": [["0", "floor"],
            ["3", "hard_floor"],
            ["rest", "wall"]]
}
