{
    "map": ["1 1 1 1 1 1 1 1 1 1 1 1 1 1 1",
            "1 3 3 0 0 0 0 0 0 0 0 0 3 3 1",
            "1 3 2 0 2 0 2 0 2 0 2 0 2 3 1",
            "1 0 0 0 0 0 0 0 0 0 0 0 0 0 1",
            "1 0 2 0 2 0 2 0 2 0 2 0 2 0 1",
            "1 0 0 0 0 0 0 0 0 0 0 0 0 0 1",
            "1 0 2 0 2 0 2 0 2 0 2 0 2 0 1",
            "1 0 0 0 0 0 0 0 0 0 0 0 0 0 1",
            "1 0 2 0 2 0 2 0 2 0 2 0 2 0 1",
            "1 0 0 0 0 0 0 0 0 0 0 0 0 0 1",
            "1 3 2 0 2 0 2 0 2 0 2 0 2 3 1",
            "1 3 3 0 0 0 0 0 0 0 0 0 3 3 1",
            "1 1 1 1 1 1 1 1 1 1 1 1 1 1 1"],

    "type": [["0", "floor"],
            ["1", "wall"],
            ["2", "wall"],
            ["3", "hard_floor"]]
}
