{
    "map": ["a m m m n o p q r o s m m m l",
            "b 8 8 0 4 3 3 3 3 3 5 0 8 8 k",
            "b 8 0 4 6 0 0 1 0 0 7 5 0 8 k",
            "b 0 4 6 0 0 0 1 0 0 0 7 5 0 k",
            "b 4 6 0 0 0 1 1 1 0 0 0 7 5 k",
            "b 2 0 0 0 1 4 3 5 1 0 0 0 2 k",
            "b 2 1 1 1 1 2 1 2 1 1 1 1 2 k",
            "b 2 0 0 0 1 7 3 6 1 0 0 0 2 k",
            "b 7 5 0 0 0 1 1 1 0 0 0 4 6 k",
            "b 0 7 5 0 0 0 1 0 0 0 4 6 0 k",
            "b 8 0 7 5 0 0 1 0 0 4 6 0 8 k",
            "b 8 8 0 7 3 3 3 3 3 6 0 8 8 k",
            "c d e f g h i d e f g h i d j"],

    "type": [["0", "floor"],
            ["8", "hard_floor"],
            ["2", "floor"],
            ["3", "floor"],
            ["4", "floor"],
            ["5", "floor"],
            ["6", "floor"],
            ["7", "floor"],
            ["8", "floor"],
            ["rest", "wall"]]
}
